oooooooooo
o____s___o
o________o
o________o
o_b__p__so
o___bo_o_o
o________o
o_s______o
o________o
oooooooooo