oooooooooo
o______s_o
o__b_____o
o___o_o__o
o____p___o
o__o___b_o
o________o
o________o
o____s___o
oooooooooo