oooooooooo
o________o
o________o
o__sp____o
o___o____o
o__b___b_o
o__o_____o
o___s____o
o________o
oooooooooo