oooooooooo
o________o
o__b_____o
o___o_o__o
o________o
o__op_b_so
o________o
o________o
o____s___o
oooooooooo