oooooooooo
osb______o
osb______o
o_oooooo_o
o________o
op_______o
o________o
o________o
o________o
oooooooooo
