oooooooooo
o___s____o
o__b_____o
o___o____o
o____p___o
o__o___b_o
o________o
o_s______o
o________o
oooooooooo
